11111111111111111111
11000011111110000111
11000000000000000111
11000000000000000111
10000000000000000011
10000000000000000011
11000000000000011111
11111000111111111111
11111111111111111111
11111111111111111111
11111111111111111111