11222222232222222111
11000000000000000111
11000000000000000111
10000000000005000011
10000000000000000011
10050000000000000011
10000000000000000011
11000000000000500111
11100000000000001111
11111111111111111111
11111111111111111111