11111222232222111111
11111000000000111111
11110000000500011111
11000000000000000111
10000000000000000011
10000500000000000011
11000000000000000111
11110000000050011111
11111100000001111111
11111111111111111111
11111111111111111111