11222211111112222111
11000022223220000111
11500000000000000111
11000000000000000111
10000000000000050011
10000000000000000011
11000500000000011111
11111000111111111111
11111111111111111111
11111111111111111111
11111111111111111111